BBBBBBBBBBBBBBBBBBBB
B   E    BBBB  GEBBB
BBBBB      BBBBBBBBB
BB              BBBB
BB              BBBB
BBBB    BBB     BBBB
BBB  G EBFBG  P    B