BBBBBBBBBBBBBBBBBBBB
B        BBBB  GPBBB
BBBBB      BBBBBBBBB
BB              BBBB
BB             WBBBB
BBBB    BBB     BBBB
BBB  G  BFBG       B