BBBBBBBBBBBBBBBBBBBB
B   E    BBBB  GEBBB
BBBBB      BBBBBBBBB
BB              BBBB
BB             WBBBB
BBBB    BBB     BBBB
BBB  G EBFBG  P    B