####################
#        ####  "P###
#####      #########
##            ~~####
##   F         ~####
####    +++     ####
###  " P+0+"   1   #