####################
#        ####  "P###
#####      #########
##   EW       ~~####
##   2     **  ~####
####    +++**   ####
###  " P+0+"   1   #