####################
#        ####  "P###
#####      #########
##   EWR      ~~####
##   2     **  ~####
####    +++**   ####
###  " P+0+"   1   #