####################
#              "F###
#####             *#
## A          ~~####
##         **  ~####
####    +++**   ####
###  " P+0+"   1   #