####################
#              "P###
#####             *#
##            ~~####
##         **  ~####
####    +++**   ####
###  " P+0+"   1   #